11111111111111111111111111111111111111111111111
1000C00000E0000000000000000000P0000000000000001
11111111111111111111111111111111111111111111111