1111111111111111111111111111111111
1E000000N000000C00000C000000000001
1010010100100000101001000A00010101
1010010010101010001001000000010101
1P0000000C00C0000000000000000000C1
1N0000A00000000C00000C0000N0000001
1010010100100000101001000000010101
1010010010101010001001000000010101
100000000C00C0000000000NA0000000C1
1111111111111111111111111111111111
