1111111111111111111111111111111111111111111111111111111111111111111111111111111111111111111111
1000000000000000000000000000000000000000000000000000000000000000000000000000000000000000000001
1000000000000000000000000000000000000000000000000000000000000000000000000000000000000000000001
100000000000000000000000000000000000000000000000000000000000000000000000000000P000000000000001
1000000000000000000000000000000000000000000000000000000000000000000000000000000000000000000001
100000000000000000000000000000000000000000000000000000000000000000000000000000E000000000000001
1000000000000000000000000001111110000000000000000000001111110111111000000000000000000000000001
1000000000000000000000000011111100000000000000000000001111100111111000000000000000000000000001
1000000000000000000000000111111000000000000000000000001111000111111000000000000000000000000001
1000000000000000000000001111110000000000000000000000001110000111111000000000000000000000000001
1000000000000000000000011111100000000000000000000000001100000111111000000000000000000000000001
1000000000000000000000111111000000000000000000000000001000000111111000000000000000000000000001
1000000000000000000001111110000000000000000000000000000000001111110000000000000000000000000001
1111111111111111111111111111111111111111111111111111111111111111111111111111111111111111111111
