11111111111111111111111111111111111111111111111111111111111111111111111111111
10000000000000000000000000000000000000000000000000000000000000000000000000001
10000000000000000000000000000000000000000000000000000000000000000000000000001
1000000000000000000000000000000000000000000000000000000000000P000000000000001
10000000000000000000000000000000000000000000000000000000000000000000000000001
1000000000000000000000000000000000000000000000000000000000000E000000000000001
10000000000000000000000000011111100001111110111111000000000000000000000000001
1000000000000000000000000011111100000111110011111100000000000C000000000000001
10000000000000000000000001111110000001111000111111000000000000000000000000001
10000000000000000000000011111100000001110000111111000000000000000000000000001
10000000000000000000000111111000000001100000111111000000000000000000000000001
10000000000000000000001111110000000001000000111111000000000000000000000000001
10000000000000000000011111100000000000000001111110000000000000000000000000001
10000000000000000000111111000000000000000011111100000000000000000000000000001
10000000000000000001111110000000000000000111111000000000000000000000000000001
10000000000000000011111100000000000000001111110000000000000000000000000000001
10000000000000000111111000000000000000011111100000000000000000000000000000001
10000000000000001111110000000000000000111111000000000000000000000000000000001
10000000000000011111111111111111100001111110000001000000000000000000000000001
10000000000000011111111111111111100001111110000011000000000000000000000000001
10000000000000011111111111111111100001111110000111000000000000000000000000001
10000000000000011111111111111111100001111110001111000000000000000000000000001
10000000000000000000000000011111100001111110011111000000000000000000000000001
10000000000000000000000000011111100001111110111111000000000000000000000000001
10000000000000000000000000011111100000000000000000000000000000000000000000001
10000000000000000000000000011111100000000000000000000000000000000000000000001
10000000000000000000000000011111100000000000000000000000000000000000000000001
10000000000000000000000000011111100000000000000000000000000000000000000000001
10000000000000000000000000000000000000000000000000000000000000000000000000001
10000000000000000000000000000000000000000000000000000000000000000000000000001
10000000000000000000000000000000000000000000000000000000000000000000000000001
10000000000000000000000000000000000000000000000000000000000000000000000000001
10000000000000000000000000000000000000000000000000000000000000000000000000001
11111111111111111111111111111111111111111111111111111111111111111111111111111
