111111
1E0000
101001
101001
1P0000
111111
